1111111331111111
1333333333333331
1333333333333331
1333333333333331
1333333333333331
3333333333333333
3333333333333333
1333333333333331
1333333333333331
1333333333333331
1333333333333331
1111111331111111

111111133111111113333333333333311333333333333331133333333333333113333333333333313333333333333333333333333333333313333333333333311333333333333331133333333333333113333333333333311111111331111111